NO ./blue.xpm
SO ./grey.xpm
WE ./purple.xpm
EA ./red.xpm




F 220,100,0
C 225,30,0

        1111111111111111111111111
        1000000000110000000000001
        1011000001110000000000001
        101000000000000000000001
111111111011000001110000000000001
100000000011000001110000000011111
11111111111111111111111111111111
11110111111111011100000000001
11110111111111011101010000001
11111111111111111111111111111
11000000110101011100000000001
10000000000000001100000000001
10000N00000000001101010000001
110000011101010111110111000111
11110111 1110101 101111000001
11111111 1111111 111111111111






