NO texture/dog1.xpm
SO texture/dog2.xpm
WE texture/dog3.xpm
EA texture/dog4.xpm

F 128,128,128
C 0,127,255

1111111
1000001
1000001
100N101
1001001
1000001
1111111