NO   texture/dog1.xpm
SO     texture/dog2.xpm
WE        texture/dog3.xpm
EA         texture/dog4.xpm

F           128,128,128
C           0,127,255

1111111
1010101
1100011
100N001
1100011
1010101
1111111
