NO   texture/redbrick.xpm
SO     texture/wood.xpm
WE       texture/pillar.xpm
EA        texture/purplestone.xpm

F           128,128,128
C          0,127,255
1
11
1S1
1001
10001
100001
1000001
10000001
100000001
1000000001
10000000001
111111111111