NO   texture/redbrick.xpm
SO     texture/wood.xpm
WE       texture/mossy.xpm
EA        texture/greystone.xpm

F           128,128,128
C          0,127,255


        11111         11111
        10001         10001
        10001         10001
        10001         10001
        1000111111111110001
        100000000S000000001
        1111111111111111111